{
	"mapName" : "map_level_0", 
	"width" : 40,
	"height" : 20,
	"gravitation" : 7,
	"spawnX" : 5,
	"spawnY" : 14,
	
	"entities": [
		{
			"type" : "dog",
			"posX":22,
			"posY":10
		},
		
		{
			"type" : "flame_spawner",
			"posX":12,
			"posY":13
		},
		
		{
			"type" : "goal",
			"posX":38,
			"posY":10
		}
	],
	
	"map" : [
	00,00,00,00,00,00,00,00,00,00,00,00,00,00,00,00,00,00,00,00,00,00,00,00,00,00,00,00,00,00,00,00,00,00,00,00,00,00,00,00,
	00,00,00,00,00,00,00,00,00,00,00,00,00,00,00,00,00,00,00,00,00,00,00,00,00,00,00,00,00,00,00,00,00,00,00,00,00,00,00,00,
	00,00,00,00,00,00,00,00,00,00,00,00,00,00,00,00,00,00,00,00,00,00,00,00,00,00,00,00,00,00,00,00,00,00,00,00,00,00,00,00,
	00,00,00,00,00,00,00,00,00,00,00,00,00,00,00,00,00,00,00,00,00,00,00,00,00,00,00,00,00,00,00,00,00,00,00,00,00,00,00,00,
	00,00,00,00,00,00,00,00,00,00,00,00,00,00,00,00,00,00,00,00,00,00,00,00,00,00,00,00,00,00,00,00,00,00,00,00,00,00,00,00,
	00,00,00,00,00,00,00,00,00,00,00,00,00,00,00,00,00,00,00,00,00,00,00,00,00,00,00,00,00,00,00,00,00,00,00,00,00,00,00,00,
	00,00,00,00,00,00,00,00,00,00,00,00,00,00,00,00,00,00,00,00,00,00,00,00,00,00,00,00,00,00,00,00,00,00,00,00,00,00,00,00,
	00,00,00,00,00,00,00,00,00,00,00,00,00,00,00,00,00,00,00,00,00,00,00,00,00,00,00,00,00,00,00,00,00,00,00,00,00,00,00,00,
	00,00,00,00,00,00,00,00,00,00,00,00,00,00,00,00,00,00,00,00,00,00,00,00,00,00,00,00,00,00,00,00,00,00,00,00,00,00,00,00,
	00,00,00,00,00,00,00,00,00,00,00,00,00,00,00,00,00,00,00,00,00,00,00,00,00,00,00,00,00,00,00,00,00,00,00,00,00,00,00,00,
	00,00,00,00,00,00,00,00,00,00,00,00,00,00,00,00,00,00,00,00,00,00,00,00,00,00,00,00,00,00,00,00,00,00,00,00,13,13,13,13,
	00,00,00,00,00,00,00,00,00,00,00,00,00,00,00,00,00,00,00,00,00,00,00,00,00,00,00,00,00,00,00,00,00,13,13,13,18,12,12,12,
	00,00,00,00,00,00,00,00,00,00,00,00,00,00,00,00,00,00,00,00,00,00,00,00,00,00,00,00,00,00,13,13,13,18,12,12,19,11,11,11,
	00,00,00,00,00,00,00,00,00,00,13,13,13,13,13,13,13,13,13,13,13,13,13,00,00,00,00,00,00,00,18,12,12,19,11,11,11,11,11,11,
	13,13,13,13,13,13,00,00,00,13,18,12,12,12,12,12,12,12,12,12,12,12,15,00,00,00,01,00,00,00,17,11,11,11,11,11,11,11,11,11,
	12,12,12,12,12,15,00,00,00,18,19,11,11,11,11,11,11,11,11,11,11,11,14,00,00,00,00,00,00,00,17,11,11,11,11,11,11,11,11,11,
	11,11,11,11,11,14,00,00,00,17,11,11,11,11,11,11,11,11,11,11,11,11,14,00,00,00,00,00,00,00,17,11,11,11,11,11,11,11,11,11,
	11,11,11,11,11,14,00,00,00,17,11,11,11,11,11,11,11,11,11,11,11,11,14,00,00,00,00,00,00,00,17,11,11,11,11,11,11,11,11,11,
	11,11,11,11,11,14,00,00,00,17,11,11,11,11,11,11,11,11,11,11,11,11,14,00,00,00,00,00,00,00,17,11,11,11,11,11,11,11,11,11,
	11,11,11,11,11,14,00,00,00,17,11,11,11,11,11,11,11,11,11,11,11,11,14,00,00,00,00,00,00,00,17,11,11,11,11,11,11,11,11,11
	]
}