{
	"mapName" : "map_level_1", 
	"width" : 80,
	"height" : 20,
	"gravitation" : 7,
	"spawnX" : 5,
	"spawnY" : 14,
	
	"entities": [
		{
			"type" : "dog",
			"posX":22,
			"posY":10
		},
		
		{
			"type" : "flame_spawner",
			"posX":12,
			"posY":13
		},
		
		{
			"type" : "fire",
			"posX":9,
			"posY":15
		},
		
		{
			"type" : "fire",
			"posX":29,
			"posY":13
		},
		
		{
			"type" : "goal",
			"posX":75,
			"posY":14
		}
	],
	
	"map" : [
	00,00,00,00,00,00,00,00,00,00,00,00,00,00,00,00,00,00,00,00,00,00,00,00,00,00,00,00,00,00,00,00,00,00,00,00,00,00,00,00,00,00,00,00,00,00,00,00,00,00,00,00,00,00,00,00,00,00,00,00,00,00,00,00,00,00,00,00,00,00,00,00,00,00,00,00,00,00,00,00,
	00,00,00,00,00,00,00,00,00,00,00,00,00,00,00,00,00,00,00,00,00,00,00,00,00,00,00,00,00,00,00,00,00,00,00,00,00,00,00,00,00,00,00,00,00,00,00,00,00,00,00,00,00,00,00,00,00,00,00,00,00,00,00,00,00,00,00,00,00,00,00,00,00,00,00,00,00,00,00,00,
	00,00,00,00,00,00,00,00,00,00,00,00,00,00,00,00,00,00,00,00,00,00,00,00,00,00,00,00,00,00,00,00,00,00,00,00,00,00,00,00,00,00,00,00,00,00,00,00,00,00,00,00,00,00,00,00,00,00,00,00,00,00,00,00,00,00,00,00,00,00,00,00,00,00,00,00,00,00,00,00,
	00,00,00,00,00,00,00,00,00,00,00,00,00,00,00,00,00,00,00,00,00,00,00,00,00,00,00,00,00,00,00,00,00,00,00,00,00,00,00,00,00,00,00,00,00,00,00,00,00,00,00,00,00,00,00,00,00,00,00,00,00,00,00,00,00,00,00,00,00,00,00,00,00,00,00,00,00,00,00,00,
	00,00,00,00,00,00,00,00,00,00,00,00,00,00,00,00,00,00,00,00,00,00,00,00,00,00,00,00,00,00,00,00,00,00,00,00,00,00,00,00,00,00,00,00,00,00,00,00,00,00,00,00,00,00,00,00,00,00,00,00,00,00,00,00,00,00,00,00,00,00,00,00,00,00,00,00,00,00,00,00,
	00,00,00,00,00,00,00,00,00,00,00,00,00,00,00,00,00,00,00,00,00,00,00,00,00,00,00,00,00,00,00,00,00,00,00,00,00,00,00,00,00,00,00,00,00,00,00,00,00,00,00,00,00,00,00,00,00,00,00,00,00,00,00,00,00,00,00,00,00,00,00,00,00,00,00,00,00,00,00,00,
	00,00,00,00,00,00,00,00,00,00,00,00,00,00,00,00,00,00,00,00,00,00,00,00,00,00,00,00,00,00,00,00,00,00,00,00,00,00,00,00,00,00,00,00,00,00,00,00,00,00,00,00,00,00,00,00,00,00,00,00,00,00,00,00,00,00,00,00,00,00,00,00,00,00,00,00,00,00,00,00,
	00,00,00,00,00,00,00,00,00,00,00,00,00,00,00,00,00,00,00,00,00,00,00,00,00,00,00,00,00,00,00,00,00,00,00,00,00,00,00,00,00,00,00,00,00,00,00,00,00,00,00,00,00,00,00,00,00,00,00,00,00,00,00,00,00,00,00,00,00,00,00,00,00,00,00,00,00,00,00,00,
	00,00,00,00,00,00,00,00,00,00,00,00,00,00,00,00,00,00,00,00,00,00,00,00,00,00,00,00,00,00,00,00,00,00,00,00,00,00,00,00,00,00,00,00,00,00,00,00,00,00,00,00,00,00,00,00,00,00,00,00,00,00,00,00,00,00,00,00,00,00,00,00,00,00,00,00,00,00,00,00,
	00,00,00,00,00,00,00,00,00,00,00,00,00,00,00,00,00,00,00,00,00,00,00,00,00,00,00,00,00,00,00,00,00,00,00,00,00,00,00,00,00,00,00,00,00,00,00,00,00,00,00,00,00,00,00,00,00,00,00,00,00,00,00,00,00,00,00,00,00,00,00,00,00,00,00,00,00,00,00,00,
	00,00,00,00,00,00,00,00,00,00,00,00,00,00,00,00,00,00,00,00,00,00,00,00,00,00,00,00,00,00,00,00,00,00,00,00,13,13,13,13,13,13,00,00,00,00,00,00,00,00,00,00,00,00,00,00,00,00,00,00,00,00,00,00,00,00,00,00,00,00,00,00,00,00,00,00,00,00,00,00,
	00,00,00,00,00,00,00,00,00,00,00,00,00,00,00,00,00,00,00,00,00,00,00,00,00,00,00,00,00,00,00,00,00,13,13,13,18,12,12,12,12,15,13,00,00,00,00,00,00,00,00,00,00,00,00,00,00,00,00,00,00,00,00,00,00,00,00,00,00,00,00,00,00,00,00,00,00,00,00,00,
	00,00,00,00,00,00,00,00,00,00,00,00,00,00,00,00,00,00,00,00,00,00,00,00,00,00,00,00,00,00,13,13,13,18,12,12,19,11,11,11,11,16,15,13,00,00,00,00,00,00,00,00,00,00,00,00,00,00,00,00,00,00,00,00,00,00,00,00,00,00,00,00,00,00,00,00,00,00,00,00,
	00,00,00,00,00,00,00,00,00,00,13,13,13,13,13,00,00,00,00,13,13,13,13,00,00,00,00,00,00,13,18,12,12,19,11,11,11,11,11,11,11,11,16,15,00,00,00,00,00,00,00,00,13,13,13,00,00,00,00,00,00,00,00,00,00,00,00,00,00,00,00,00,00,00,00,00,00,00,00,00,
	13,13,13,13,13,13,00,00,00,00,18,12,12,12,15,00,00,00,00,18,12,12,15,00,00,00,00,00,13,18,19,11,11,11,11,11,11,11,11,11,11,11,11,14,13,13,13,00,00,00,00,00,18,12,15,00,00,00,00,13,13,13,00,00,00,00,00,00,00,00,00,00,00,00,13,13,13,00,00,00,
	12,12,12,12,12,15,00,00,00,13,17,11,11,11,14,00,00,00,00,17,11,11,14,00,00,00,00,00,18,19,11,11,11,11,11,11,11,11,11,11,11,11,11,16,12,12,15,00,00,00,00,00,17,11,14,00,00,00,00,18,12,15,00,00,00,00,00,01,00,00,00,00,00,00,18,12,15,00,00,00,
	11,11,11,11,11,14,00,00,00,18,19,11,11,11,14,00,00,00,00,17,11,11,14,00,00,00,00,00,17,11,11,11,11,11,11,11,11,11,11,11,11,11,11,11,11,11,14,00,00,00,00,00,17,11,14,00,00,00,00,17,11,14,00,00,00,00,00,00,00,00,00,00,00,00,17,11,14,00,00,00,
	11,11,11,11,11,14,00,00,00,17,11,11,11,11,14,00,00,00,00,17,11,11,14,00,00,00,00,00,17,11,11,11,11,11,11,11,11,11,11,11,11,11,11,11,11,11,14,00,00,00,00,00,17,11,14,00,00,00,00,17,11,14,00,00,00,00,00,00,00,00,00,00,00,00,17,11,14,00,00,00,
	11,11,11,11,11,14,00,00,00,17,11,11,11,11,14,00,00,00,00,17,11,11,14,00,00,00,00,00,17,11,11,11,11,11,11,11,11,11,11,11,11,11,11,11,11,11,14,00,00,00,00,00,17,11,14,00,00,00,00,17,11,14,00,00,00,00,00,00,00,00,00,00,00,00,17,11,14,00,00,00,
	11,11,11,11,11,14,00,00,00,17,11,11,11,11,14,00,00,00,00,17,11,11,14,00,00,00,00,00,17,11,11,11,11,11,11,11,11,11,11,11,11,11,11,11,11,11,14,00,00,00,00,00,17,11,14,00,00,00,00,17,11,14,00,00,00,00,00,00,00,00,00,00,00,00,17,11,14,00,00,00
	]
}