{
	"mapName" : "Test", 
	"width" : 20,
	"height" : 20,
	"gravitation" : 7,
	"spawnX" : 5,
	"spawnY" : 13,
	
	"entities": [
		{
			"type" : "dog",
			"posX":6,
			"posY":14
		}
	],
	
	"map" : [
	00,00,00,00,00,00,00,00,00,00,00,00,00,00,00,00,00,00,00,00,
	00,00,00,00,00,00,00,00,00,00,00,00,00,00,00,00,00,00,00,00,
	00,00,00,00,00,00,00,00,00,00,00,00,00,00,00,00,00,00,00,00,
	00,00,00,00,00,00,00,00,00,00,00,00,00,00,00,00,00,00,00,00,
	00,00,00,00,00,00,00,00,00,00,00,00,00,00,00,00,00,00,00,00,
	00,00,00,00,00,00,00,00,00,00,00,00,00,00,00,00,00,00,00,00,
	00,00,00,00,00,00,00,00,00,00,00,00,00,00,00,00,00,00,00,00,
	00,00,00,00,00,00,00,00,00,00,00,00,00,00,00,00,00,00,00,00,
	00,00,00,00,00,00,00,00,00,00,00,00,00,00,00,00,00,00,00,00,
	00,00,00,00,00,00,00,00,00,00,00,00,00,00,00,00,00,00,00,00,
	00,00,00,00,00,00,00,00,00,00,00,00,00,00,00,00,00,00,00,00,
	00,00,00,00,00,00,00,00,00,00,00,00,00,00,00,00,13,13,13,13,
	00,00,00,00,00,00,00,00,00,00,00,00,00,13,13,13,12,12,12,12,
	13,13,13,13,00,00,00,00,00,00,13,13,13,12,12,12,11,11,11,11,
	12,12,12,12,13,13,00,00,00,13,12,12,12,11,11,11,11,11,11,11,
	11,11,11,11,12,12,13,13,13,12,11,11,11,11,11,11,11,11,11,11,
	11,11,11,11,11,11,12,12,12,11,11,11,11,11,11,11,11,11,11,11,
	11,11,11,11,11,11,11,11,11,11,11,11,11,11,11,11,11,11,11,11,
	11,11,11,11,11,11,11,11,11,11,11,11,11,11,11,11,11,11,11,11,
	11,11,11,11,11,11,11,11,11,11,11,11,11,11,11,11,11,11,11,11
	]
}