{
	"mapName" : "Test", 
	"width" : 40,
	"height" : 20,
	"gravitation" : 7,
	"spawnX" : 5,
	"spawnY" : 13,
	
	"entities": [
		{
			"type" : "dog",
			"posX":12,
			"posY":10
		},
		{
			"type" : "dog",
			"posX":15,
			"posY":10
		},
		
		{
			"type" : "fire",
			"posX":9,
			"posY":14
		},
		
		{
			"type" : "goal",
			"posX":38,
			"posY":10
		}
	],
	
	"map" : [
	00,00,00,00,00,00,00,00,00,00,00,00,00,00,00,00,00,00,00,00,00,00,00,00,00,00,00,00,00,00,00,00,00,00,00,00,00,00,00,00,
	00,00,00,00,00,00,00,00,00,00,00,00,00,00,00,00,00,00,00,00,00,00,00,00,00,00,00,00,00,00,00,00,00,00,00,00,00,00,00,00,
	00,00,00,00,00,00,00,00,00,00,00,00,00,00,00,00,00,00,00,00,00,00,00,00,00,00,00,00,00,00,00,00,00,00,00,00,00,00,00,00,
	00,00,00,00,00,00,00,00,00,00,00,00,00,00,00,00,00,00,00,00,00,00,00,00,00,00,00,00,00,00,00,00,00,00,00,00,00,00,00,00,
	00,00,00,00,00,00,00,00,00,00,00,00,00,00,00,00,00,00,00,00,00,00,00,00,00,00,00,00,00,00,00,00,00,00,00,00,00,00,00,00,
	00,00,00,00,00,00,00,00,00,00,00,00,00,00,00,00,00,00,00,00,00,00,00,00,00,00,00,00,00,00,00,00,00,00,00,00,00,00,00,00,
	00,00,00,00,00,00,00,00,00,00,00,00,00,00,00,00,00,00,00,00,00,00,00,00,00,00,00,00,00,00,00,00,00,00,00,00,00,00,00,00,
	00,00,00,00,00,00,00,00,00,00,00,00,00,00,00,00,00,00,00,00,00,00,00,00,00,00,00,00,00,00,00,00,00,00,00,00,00,00,00,00,
	00,00,00,00,00,00,00,00,00,00,00,00,00,00,00,00,00,00,00,00,00,00,00,00,00,00,00,00,00,00,00,00,00,00,00,00,00,00,00,00,
	00,00,00,00,00,00,00,00,00,00,00,00,00,00,00,00,00,00,00,00,00,00,00,00,00,00,00,00,00,00,00,00,00,00,00,00,00,00,00,00,
	00,00,00,00,00,00,00,00,00,00,00,00,00,00,00,00,00,00,00,00,00,00,00,00,00,00,00,00,00,00,00,00,00,00,00,00,13,13,13,13,
	00,00,00,00,00,00,00,00,00,00,00,00,00,00,00,00,00,00,00,00,00,00,00,00,00,00,00,00,00,00,00,00,00,13,13,13,18,12,12,12,
	00,00,00,00,00,00,00,00,00,00,00,00,00,00,00,00,00,00,00,00,00,00,00,00,00,00,00,00,00,00,13,13,13,18,12,12,19,11,11,11,
	00,00,00,00,00,00,00,00,00,00,13,13,13,13,13,13,13,13,13,13,13,13,13,00,00,00,00,00,00,13,18,12,12,19,11,11,11,11,11,11,
	13,13,13,13,13,13,00,00,00,13,18,12,12,12,12,12,12,12,12,12,12,12,15,00,00,00,00,00,13,18,19,11,11,11,11,11,11,11,11,11,
	12,12,12,12,12,15,00,00,00,18,19,11,11,11,11,11,11,11,11,11,11,11,14,00,00,00,00,00,18,19,11,11,11,11,11,11,11,11,11,11,
	11,11,11,11,11,14,00,00,00,17,11,11,11,11,11,11,11,11,11,11,11,11,14,00,00,00,00,00,17,11,11,11,11,11,11,11,11,11,11,11,
	11,11,11,11,11,14,00,00,00,17,11,11,11,11,11,11,11,11,11,11,11,11,14,00,00,00,00,00,17,11,11,11,11,11,11,11,11,11,11,11,
	11,11,11,11,11,14,00,00,00,17,11,11,11,11,11,11,11,11,11,11,11,11,14,00,00,00,00,00,17,11,11,11,11,11,11,11,11,11,11,11,
	11,11,11,11,11,14,00,00,00,17,11,11,11,11,11,11,11,11,11,11,11,11,14,00,00,00,00,00,17,11,11,11,11,11,11,11,11,11,11,11
	]
}